775 735 735 735 735 735 735 735 735 735 735 735 735 735 735 735 735 735 735 735 735 735 735 735 735 735 735 735 735 735 735 735 735 735 735 735 735 735 735 735 735 735 735 735 735 735 735 735 735 774 
736 744 0 0 0 0 0 0 0 0 0 0 0 0 0 0 0 0 0 0 0 0 0 0 0 0 0 0 0 0 0 0 0 0 0 0 0 0 0 0 0 0 0 0 0 0 0 0 745 736 
736 0 0 0 0 0 0 0 0 0 0 0 0 0 0 0 0 0 0 0 0 0 0 0 0 0 0 0 0 0 0 0 0 0 0 0 0 0 0 0 0 0 0 0 0 0 0 0 0 736 
736 0 0 0 0 0 0 0 0 0 0 0 0 0 0 0 0 0 0 0 0 0 0 0 0 0 0 0 0 0 0 0 0 0 0 0 0 0 0 0 0 0 0 0 0 0 0 0 0 736 
736 736 736 736 0 0 0 0 0 0 0 0 0 0 0 0 0 0 0 0 0 0 0 0 0 0 0 0 0 0 0 0 0 0 0 0 0 0 0 0 0 0 0 0 0 0 0 0 0 736 
736 736 736 736 736 0 0 0 0 0 0 0 0 0 0 0 0 0 0 0 0 0 0 0 0 0 0 0 0 0 0 0 0 0 0 0 0 0 0 0 0 0 0 0 0 71 0 0 0 736 
736 736 736 736 736 796 796 796 796 796 796 796 796 796 796 796 796 796 796 796 796 796 796 796 796 796 796 0 0 0 0 736 0 0 0 0 0 0 0 0 0 0 0 0 737 737 0 0 0 736 
736 736 736 736 865 0 0 0 0 0 0 0 0 0 0 0 0 0 0 0 0 0 0 0 0 0 0 0 0 0 0 736 71 71 0 0 0 0 0 0 0 0 0 0 737 737 0 0 737 736 
736 736 736 736 865 0 0 0 0 0 0 0 0 0 0 0 0 0 0 0 0 0 0 0 0 0 0 0 0 0 0 736 736 736 71 71 0 0 0 0 0 0 0 0 737 735 0 0 0 736 
736 736 736 736 865 0 0 71 0 0 0 0 0 0 0 0 0 0 0 0 71 0 0 0 0 0 0 0 0 0 0 736 0 736 736 736 71 71 0 0 0 0 0 737 737 735 0 0 0 736 
736 736 736 736 865 0 0 796 795 795 795 795 795 795 795 795 795 795 795 795 795 795 795 795 795 795 795 795 795 795 795 736 0 0 0 736 736 736 71 0 0 0 0 737 737 737 737 0 0 736 
736 736 736 736 865 0 0 0 0 0 0 0 0 0 0 0 0 0 0 0 0 0 0 0 0 0 0 0 0 0 0 736 0 0 0 0 0 736 736 736 736 0 0 735 735 735 735 0 0 736 
736 736 736 736 865 0 0 0 0 0 0 0 0 0 0 0 0 0 0 0 0 0 0 0 0 0 0 0 0 0 0 736 0 0 0 0 0 0 0 736 736 71 71 735 735 735 0 0 0 736 
736 736 736 736 865 0 0 0 0 0 0 0 0 0 0 71 0 0 0 0 0 0 0 0 0 0 0 0 0 0 0 736 0 0 0 0 0 0 0 0 736 736 736 737 735 735 0 0 0 736 
736 736 736 736 736 795 795 795 795 795 795 795 795 795 795 795 795 795 795 795 795 795 795 795 796 795 795 796 0 0 0 736 0 0 0 0 0 0 0 0 0 0 0 0 0 0 0 0 735 736 
736 736 736 736 865 0 0 0 0 0 0 0 0 0 0 0 0 0 0 0 0 0 0 0 0 0 0 0 0 0 0 736 0 0 0 0 0 0 0 0 0 0 0 0 0 0 0 0 0 736 
736 736 736 736 865 0 0 0 0 0 0 0 0 0 0 0 0 0 0 0 0 0 0 0 0 0 0 0 0 0 0 736 0 0 0 0 0 0 0 0 0 0 0 0 0 0 0 0 0 736 
736 736 736 736 865 0 0 0 0 0 0 0 0 0 0 0 0 0 0 0 0 0 0 0 71 0 0 0 0 0 0 736 0 0 0 0 0 0 0 0 0 0 0 0 0 0 0 0 0 736 
736 736 736 736 865 0 0 0 795 795 795 795 795 795 795 795 795 795 795 795 795 795 795 795 795 795 795 795 795 795 795 736 0 0 0 0 0 0 0 0 0 0 0 0 0 0 0 71 71 736 
736 736 736 736 865 0 0 0 0 0 0 0 0 0 0 0 0 0 0 0 0 0 0 0 0 0 0 0 0 0 0 736 0 0 0 0 0 0 0 0 0 0 0 0 0 0 736 736 736 736 
736 736 736 736 865 0 0 0 0 0 0 0 0 0 0 0 0 0 0 0 0 0 0 0 0 0 0 0 0 0 0 736 0 0 0 0 0 0 0 0 0 0 0 71 71 71 736 0 0 736 
736 736 736 736 865 0 0 71 0 0 0 0 0 0 0 0 0 0 0 71 0 0 0 0 0 0 0 0 0 0 0 736 0 0 0 0 0 0 0 0 0 71 71 736 736 736 736 0 0 736 
736 736 736 736 736 795 795 795 795 795 795 795 795 795 795 795 795 795 795 795 795 795 795 795 795 795 795 795 0 0 0 736 0 0 0 0 0 0 0 0 71 736 736 736 0 0 0 0 0 736 
736 736 736 736 736 0 0 0 0 0 0 0 0 0 0 0 0 0 0 0 0 0 0 0 0 0 0 0 0 0 0 736 0 0 0 0 0 0 0 71 736 736 0 0 0 0 0 0 0 736 
736 736 736 736 0 0 0 0 0 0 0 0 0 0 0 0 0 0 0 0 0 0 0 0 0 0 0 0 0 0 0 736 0 0 0 0 0 0 71 736 736 0 0 0 0 0 0 0 0 736 
736 0 0 0 0 0 0 0 795 71 71 71 796 796 795 795 795 795 795 795 795 795 795 795 795 795 795 795 795 795 795 736 0 0 0 0 0 0 736 736 0 0 0 0 0 0 0 0 0 736 
736 0 0 0 0 0 0 0 795 795 796 796 796 0 0 0 0 0 0 0 0 0 0 0 0 0 0 0 0 0 0 0 0 0 0 0 0 0 0 0 0 0 0 0 0 0 0 0 0 736 
736 0 0 0 0 0 0 0 0 0 0 0 0 0 0 0 0 0 0 0 0 0 0 0 0 0 0 0 0 0 0 0 0 0 0 0 0 0 0 0 0 0 0 0 0 0 0 0 0 736 
736 774 0 0 0 0 0 0 0 0 0 0 0 0 0 0 0 0 0 0 0 0 0 0 0 0 0 0 0 0 0 0 0 0 71 0 0 0 0 0 0 0 0 0 0 0 0 254 775 736 
745 735 736 736 736 736 736 736 736 736 736 736 736 736 736 736 736 736 736 736 736 736 736 736 736 736 736 736 736 736 736 736 735 735 735 735 735 735 735 735 735 735 735 735 735 735 735 735 735 744

