153 153 153 153 153 153 153 153 153 153 153 153 153 153 153 153 153 153 153 153 153 153 153 153 153 153 153 153 153 153 153 153 153 153 153 153 153 153 153 153 153 153 153 153 153 153 153 153 153 153 
153 0 0 0 0 0 0 0 0 0 0 0 0 0 0 0 0 0 0 0 0 0 0 0 0 0 0 0 0 74 0 0 0 0 0 0 74 0 0 0 0 0 0 0 0 0 0 0 0 153 
153 0 0 0 0 0 0 0 0 0 0 0 0 0 0 0 0 0 0 0 0 0 0 0 0 0 0 0 0 74 0 0 0 0 0 0 74 0 0 0 0 0 0 0 0 0 0 0 0 153 
153 0 0 0 0 0 0 0 0 0 0 0 0 0 0 0 0 0 0 0 0 0 0 0 0 0 0 0 0 74 0 0 0 0 0 0 74 0 0 0 0 0 0 0 0 0 0 0 0 153 
153 0 0 0 0 0 0 0 0 0 0 0 0 0 0 0 0 0 0 0 0 0 0 0 0 0 0 0 0 74 0 0 0 0 0 0 74 0 0 0 0 0 0 0 0 0 0 0 0 153 
153 0 0 0 0 0 0 0 0 0 0 0 0 0 0 0 0 0 0 0 0 0 0 0 0 0 0 0 0 74 0 0 0 0 0 0 74 0 0 0 0 0 0 0 0 0 0 0 0 153 
153 0 0 0 0 0 0 0 0 0 0 0 0 0 0 0 0 0 0 0 0 0 0 0 0 0 0 0 0 74 0 0 0 0 0 0 74 0 0 0 0 0 0 0 0 0 0 0 0 153 
153 0 0 0 0 0 0 0 0 0 0 0 0 0 0 0 0 0 0 0 0 0 0 0 0 0 0 0 0 74 0 0 0 0 0 0 74 0 0 0 0 0 0 0 0 0 0 0 0 153 
153 0 0 0 0 0 0 0 0 0 0 0 0 0 0 0 0 0 0 0 0 0 0 0 0 0 0 0 0 74 0 0 0 0 0 0 74 0 0 0 0 0 0 0 0 0 0 0 0 153 
153 0 0 0 0 0 0 0 0 0 0 0 0 0 0 0 0 0 0 0 0 0 0 0 0 0 0 0 0 74 0 0 0 0 0 0 74 0 0 0 0 0 0 0 0 0 0 0 0 153 
153 0 0 0 0 0 0 0 0 0 0 0 0 0 0 0 0 0 0 0 0 0 0 0 0 0 0 0 0 74 0 0 0 0 0 0 74 0 0 0 0 0 0 0 0 0 0 0 0 153 
153 0 0 0 0 0 0 0 0 0 0 0 0 0 0 0 0 0 0 0 0 0 0 0 0 0 0 0 0 74 0 0 0 0 0 0 74 0 0 0 0 0 0 0 0 0 0 0 0 153 
153 0 0 0 0 0 0 0 0 0 0 0 0 0 0 0 0 0 0 0 0 0 0 0 0 0 0 0 0 74 0 0 0 0 0 0 74 0 0 0 0 0 0 0 0 0 0 0 0 153 
153 0 0 0 0 0 0 0 0 0 0 0 0 0 0 0 0 0 0 0 0 0 0 0 0 0 0 0 0 74 0 0 0 0 0 0 74 0 0 0 0 0 0 0 0 0 0 0 0 153 
153 0 0 0 0 0 0 0 0 0 0 0 0 0 0 0 0 0 0 0 0 0 0 0 0 0 0 0 0 74 0 0 0 0 0 0 74 0 0 0 0 0 0 0 0 0 0 0 0 153 
153 0 0 0 0 0 0 0 0 0 0 0 0 0 0 0 0 0 0 0 0 0 0 0 0 0 0 0 0 74 0 0 331 332 303 303 303 303 303 334 301 0 0 0 0 0 0 0 0 153 
153 0 0 0 0 0 0 0 0 0 0 0 0 0 0 0 0 0 0 0 0 0 0 0 0 0 0 0 0 74 0 0 0 0 0 0 0 0 0 0 0 0 0 0 0 0 0 0 0 153 
153 0 0 0 0 0 0 0 0 0 247 243 14 13 14 13 243 248 0 0 0 0 0 0 0 0 0 0 0 74 0 0 0 0 0 0 0 0 0 0 0 0 0 0 0 0 0 0 0 153 
153 0 0 0 0 0 0 0 0 247 277 275 43 43 43 43 275 278 248 0 0 0 0 0 0 331 332 303 304 302 303 304 334 301 0 0 0 0 0 0 0 0 0 0 0 0 0 0 0 153 
153 0 0 0 0 0 0 0 247 277 275 275 43 43 43 43 275 275 278 248 0 0 872 0 0 0 0 0 0 0 0 0 0 0 0 0 0 0 0 0 0 0 0 0 0 0 0 0 0 153 
153 0 0 0 0 0 0 247 277 275 275 275 43 43 43 43 275 275 275 278 248 0 428 0 0 0 0 0 0 0 0 0 0 0 0 0 0 0 0 0 0 0 0 0 0 0 0 0 254 153 
153 124 125 123 124 125 123 125 123 124 125 123 43 43 43 43 123 124 125 123 124 123 124 125 548 548 549 548 549 549 548 548 125 123 71 71 71 71 71 71 71 71 71 124 124 123 124 125 123 153 
155 155 155 155 155 155 155 155 155 155 155 155 43 43 43 43 155 155 155 155 155 155 155 155 578 579 579 580 579 579 580 581 155 155 155 155 155 153 155 155 155 155 155 155 155 155 155 155 155 153 
155 155 155 155 155 155 155 155 155 155 155 155 43 43 43 43 155 155 155 155 155 155 155 155 578 579 580 581 579 579 580 581 155 155 155 155 155 153 155 155 155 155 155 155 155 155 155 155 155 155 
155 155 155 155 155 155 155 155 155 155 155 155 43 43 43 43 155 155 155 155 155 155 155 155 578 579 580 581 579 579 580 581 155 155 155 155 155 153 155 155 155 155 155 155 155 155 155 155 155 155 
155 155 155 155 155 155 155 155 155 155 155 155 43 43 43 43 155 155 155 155 155 155 155 155 578 579 580 581 579 579 580 581 155 155 155 155 155 153 155 155 155 155 155 155 155 155 155 155 155 155 
155 155 155 155 155 155 155 155 155 155 155 155 43 43 43 43 155 155 155 155 155 155 155 155 578 579 580 581 579 579 580 581 155 155 155 155 155 153 155 155 155 155 155 155 155 155 155 155 155 155 
155 155 155 155 155 155 155 155 155 155 155 155 43 43 43 43 155 155 155 155 155 155 155 155 578 579 580 581 579 579 580 581 155 155 155 155 155 153 155 155 155 155 155 155 155 155 155 155 155 155 
155 155 155 155 155 155 155 155 155 155 155 155 43 43 43 43 155 155 155 155 155 155 155 155 578 579 580 581 579 579 580 581 155 155 155 155 155 153 155 155 155 155 155 155 155 155 155 155 155 155 
155 155 155 155 155 155 155 155 155 155 155 155 43 43 43 43 155 155 155 155 155 155 155 155 578 579 580 581 579 579 580 581 155 155 155 155 155 153 155 155 155 155 155 155 155 155 155 155 155 155

