527 527 527 527 527 527 527 527 527 527 527 527 527 527 527 527 527 527 527 527 527 527 527 527 527 527 527 527 527 527 527 527 527 527 527 527 527 527 527 527 527 527 527 527 527 527 527 527 527 527 
527 0 0 0 0 0 0 0 0 0 0 0 0 0 0 0 0 0 0 0 0 0 0 0 0 0 0 0 0 0 0 0 0 0 0 0 0 0 0 0 0 0 0 0 0 0 0 0 0 527 
527 0 0 0 0 0 0 0 0 0 0 0 0 0 0 0 0 0 0 0 0 0 0 0 0 0 0 0 0 0 0 0 0 0 0 0 0 0 0 0 0 0 0 0 0 0 0 0 0 527 
527 0 0 0 0 0 0 0 0 0 0 0 0 0 0 0 0 0 0 0 0 0 0 0 0 0 0 0 0 497 497 0 0 0 0 0 0 0 0 0 0 0 0 0 0 0 0 0 0 527 
527 0 0 0 0 0 0 0 0 0 497 497 497 497 497 0 0 0 0 0 0 0 0 0 0 0 0 0 0 0 0 0 0 0 0 0 0 497 497 497 497 0 0 0 0 0 0 0 0 527 
527 0 0 0 0 0 0 0 0 0 0 0 0 0 527 497 497 497 497 497 497 497 497 497 497 497 0 0 0 0 0 0 0 0 497 497 497 497 0 0 0 0 0 0 0 0 0 0 0 527 
527 0 0 0 0 0 0 0 0 0 0 0 0 0 527 0 0 0 0 0 0 0 0 0 0 527 0 0 0 0 0 0 0 0 527 0 0 0 0 0 0 0 0 0 0 0 0 0 0 527 
527 0 0 0 0 0 0 0 0 0 0 0 0 0 527 0 0 0 0 0 0 0 0 0 254 527 0 0 0 0 0 0 0 0 527 0 0 0 0 0 0 0 0 0 0 497 497 497 497 527 
527 0 0 0 497 497 497 497 497 497 497 497 497 497 527 0 0 0 0 0 497 497 497 497 497 527 496 496 496 496 496 497 497 497 527 0 0 0 0 0 0 0 0 0 0 0 0 0 0 527 
527 0 0 0 0 0 0 0 0 0 527 0 0 0 0 0 0 0 0 0 0 527 0 0 0 0 0 0 0 0 0 0 0 0 527 0 0 535 535 535 0 0 0 0 0 0 0 0 0 527 
527 0 0 0 0 0 0 0 0 0 527 0 0 0 0 0 0 0 0 0 0 527 0 0 0 0 0 0 0 0 0 0 0 0 527 0 0 0 0 0 0 0 0 0 0 0 0 0 0 527 
527 0 0 0 0 0 0 0 0 0 527 0 0 0 0 0 497 497 497 497 497 527 497 497 497 497 0 0 0 0 0 0 0 0 527 0 0 0 0 0 0 0 0 0 0 0 0 0 0 527 
527 0 0 0 0 0 0 0 0 0 527 0 0 0 0 0 0 0 0 0 0 0 0 0 0 527 0 0 497 497 497 0 0 0 527 499 499 499 499 499 499 499 0 0 0 0 0 0 0 527 
527 0 0 0 0 0 0 0 0 0 527 0 0 0 0 0 0 0 0 0 0 0 0 0 0 0 0 0 0 0 527 0 0 0 0 0 0 527 0 0 0 0 0 0 0 0 0 0 0 527 
527 497 497 497 0 0 0 0 0 0 527 497 497 497 497 497 497 497 497 497 497 497 0 0 0 0 0 0 0 0 527 0 0 0 0 0 0 527 0 0 0 0 0 0 0 0 0 497 497 527 
527 0 0 527 0 0 0 0 0 0 0 0 0 0 0 0 0 0 0 0 0 527 497 497 497 497 497 497 497 497 527 497 497 497 0 0 0 527 0 0 0 0 0 0 0 0 0 0 0 527 
527 0 0 527 0 0 0 0 0 0 0 0 0 0 0 0 0 0 0 0 0 0 0 0 0 0 0 0 0 0 0 0 0 0 0 0 0 527 0 0 0 0 0 0 0 0 0 0 0 527 
527 0 0 527 0 0 0 0 0 0 0 0 0 0 0 0 0 0 0 0 0 0 0 0 0 0 0 0 0 0 0 0 0 0 0 0 0 527 0 0 0 0 0 0 0 497 497 497 497 527 
527 0 0 527 497 497 497 497 497 497 497 497 497 497 497 497 497 497 497 497 497 497 497 497 497 497 497 497 497 497 497 497 497 497 497 497 497 527 0 0 0 0 0 0 0 0 0 0 0 527 
527 0 0 0 0 0 0 0 0 0 0 0 0 0 0 0 0 0 0 0 0 0 0 0 0 0 0 0 0 0 0 0 0 0 0 0 0 0 0 0 0 0 0 0 0 0 0 0 0 527 
527 0 0 0 0 0 0 0 0 0 0 0 0 0 0 0 0 0 0 0 0 0 0 0 0 0 0 0 0 0 0 0 0 0 0 0 0 0 0 535 535 535 535 0 0 0 0 0 0 527 
527 0 0 0 0 0 0 0 0 0 0 0 0 0 0 0 0 0 0 0 0 0 0 0 0 0 0 0 0 0 0 0 0 0 0 0 0 0 0 0 0 0 0 0 0 0 0 0 0 527 
527 0 0 0 0 0 0 0 0 0 0 0 0 0 0 0 0 0 0 0 0 0 0 0 0 0 0 0 0 0 0 0 0 0 0 0 0 0 0 0 0 0 0 0 0 0 500 499 530 527 
527 0 0 0 0 0 0 0 0 0 0 0 0 0 0 0 0 0 0 0 0 0 0 0 0 0 0 0 0 0 0 0 0 0 0 0 0 0 0 0 0 0 0 0 0 0 0 0 0 527 
527 0 0 0 0 0 0 624 0 0 0 0 0 0 0 0 0 0 0 618 0 0 0 0 0 0 0 0 0 0 0 625 0 0 0 0 0 0 0 0 0 0 0 627 0 0 0 0 0 527 
527 0 0 0 0 0 0 658 0 0 0 0 0 0 0 0 0 0 0 676 0 0 0 0 0 0 0 0 0 0 0 658 0 0 0 0 0 0 0 0 0 0 0 657 0 0 0 0 0 527 
527 497 497 497 497 497 497 497 497 497 497 497 497 497 497 497 497 497 497 497 497 497 497 497 497 497 497 497 497 497 497 497 497 497 497 497 497 497 497 497 497 497 497 497 497 497 497 497 497 527 
527 527 527 527 527 527 527 527 527 527 527 527 527 527 527 527 527 527 527 527 527 527 527 527 527 527 527 527 527 527 527 527 527 527 527 527 527 527 527 527 527 527 527 527 527 527 527 527 527 527 
527 527 527 527 527 527 527 527 527 527 527 527 527 527 527 527 527 527 527 527 527 527 527 527 527 527 527 527 527 527 527 527 527 527 527 527 527 527 527 527 527 527 527 527 527 527 527 527 527 527 
527 527 527 527 527 527 527 527 527 527 527 527 527 527 527 527 527 527 527 527 527 527 527 527 527 527 527 527 527 527 527 527 527 527 527 527 527 527 527 527 527 527 527 527 527 527 527 527 527 527

